R 1920 1080

F	10,42,24
C	10,6,55
SO ./tests/baguette
NO ./tests/patate
WE ./tests/fromage
EA ./tests/biere


S ./tests/champagne



1111111111111111111111111111111
00000010101010111111111111111
10100010101010
00110001010101010
0011000100000011
00110010101010101
001100000011111000
1111110001111000001
11111111111111100000