R 1920 1080

F	10,42,24
C	10,6,55
SO ./tests/baguette
NO ./tests/patate
WE ./tests/fromage
EA ./tests/biere


S ./tests/champagne



11111111111111111111111111111
10000000000000010000000000001
10010000000010010000000000001
10001000000100010000000000001
10000100001000010000000000001
10000010010000011111111111111
10000001100000010000000000001
10000001100000010000000000001
10000001100000010000000000001
10000001100000010000000000001
10000000000000010000000000001
11111111111111111111111111111
