R 500 500
F 110,100,0
C 115,30,0
SO ./textures/colorstone.xpm
NO ./textures/mossy.xpm
WE ./textures/purplestone.xpm
EA ./textures/redbrick.xpm
S ./textures/barrel.xpm
11111
1E001
11111