R 833 645
F 110,100,0
C 115,30,0
SO ./textures/colorstone.xpm
NO ./textures/mossy.xpm
WE ./textures/purplestone.xpm
EA ./textures/redbrick.xpm
S ./textures/barrel.xpm
111111111111111111111111111111
100000000011000000000000111111
101100000111000100100000111111
100000000000000000000000111111
100000000000000N00000000111111
100000000000000000000000111111
111111111011000001110000111111
100000000011000001110111111111
111101111111110111000000100011
111101111111110111010100100011
110000001101010111000000100011
100010000000000011000000100011
100000000000000011010100100011
110000011101010111110111100011
111101111111010111011110100011
111111111111111111111111111111