R 700 700
F 220,100,0
C 225,30,0
SO ./textures/colorstone.xpm
NO ./textures/mossy.xpm
WE ./textures/purplestone.xpm
EA ./textures/redbrick.xpm
S ./textures/barrel.xpm
        1111111111111111111111111
        1000000000110000000000001
        1011000001110000002000001
        1001000000000000000000001
111111111011000001110000000000001
10000000001100000111011111111111111111
11110111111111011100000010001020000021
11110111111111011101010010001002020001
11000000110101011100000010001020020001
11111000000000001100000010000000000201
    1000000000000000000000001111111111
    10000E0000001100000000001
11111000000000000000000000001
10000000000000001101010010001
1100000111010101111101111000111
11110111 1110101 101111010001
11111111 1111111 111111111111