R 500 500
F 110,100,0
C 115,30,0
SO ./textures/colorstone.xpm
NO ./textures/mossy.xpm
WE ./textures/purplestone.xpm
EA ./textures/redbrick.xpm
S ./textures/barrel.xpm
            111111111111111111111111
            100000000000011000000001
            101100000000111000020001
            100100000000000000000001
111111111111101100000001110000000001
100000000000000000011001111111111111
11111011111111100001100000000001
10000000000000000001100000000001
10000200000000000001100000000001
10000000000000000001100000000001
100000000111020000011111111W000111
1111110111  1111011 101111011111
1111111111  1111111 111111111111