R 250 250
F 0,255,0
C 0,0,255
SO ./textures/colorstone.xpm
NO ./textures/mossy.xpm
WE ./textures/purplestone.xpm
EA ./textures/redbrick.xpm
S ./textures/barrel.xpm
1111111111111111111111111111111111
1000000000110000000000000000000001
1011000001110001001000000000000001
10000000000000000000000000000000001
100000000000000000E0000011111111111
1000000000000000000000001
1111111110110000011100001
1000000000110000011101111
1111011111111101110001111
1111011111111101110101
1100000011010101110001111
1000100000000000110000001
1000000000000000110101001
1100000111010101111101111
1111011111110101110111101
1111111111111111111111111