R 700 700
F 220,100,0
C 225,30,0
SO ./textures/colorstone.xpm
NO ./textures/mossy.xpm
WE ./textures/purplestone.xpm
EA ./textures/redbrick.xpm
S ./textures/barrel.xpm
111111111111111       1111111111111111
 100000000000001     1000000000000001
  100000000000001   1000000000000001
   100000000000001 1000000000000001
    100000000000011100000000000001
     1000000000000N00000000000001
      10000000000111000000000001
      10000000000111000000000001
     1000000000000000000000000001
    100000000000001000000000000001
   100000000000001 1000000000000001
  100000000000001   1000000000000001
 100000000000001     1000000000000001
111111111111111       1111111111111111