R 250 250
C 255,255,0
F 225   , 255, 255
SO ./textures/colorstone.xpm
SB ./textures/mossy.xpm
WE ./textures/purplestone.xpm
EA ./textures/redbrick.xpm
S ./textures/barrel.xpm
1111111   1111111111
10001211111200001011
1N002111010000211111
11111111111111111
1 1  111