R 250 250
C 255,255,0
F 225   , 255, 255
SO ./textures/colorstone.xpm
NO ./textures/mossy.xpm
WE ./textures/purplestone.xpm
EA ./textures/redbrick.xpm
S ./textures/barrel.xpm
1111111   1111111111
11001211111200001011
10002102010000212111
111111111111111111
11111100000001
1 1  1N01111111
     111